NO textures/guts.xpm
SO textures/griffith.xpm
WE textures/sisi.xpm
EA textures/void.xpm


F 15,15,15
C 0,1,1



11111111111111111111111
100000000000000000000E1
10000000000011111111111
1000000000001
1000000000001
1000000000001
100000000000111111111111
100000000000000000000001
100000000000000000000001
100000000000000000000001
111111111111111111111111
