1111111111
1000000001
1111100001
1000000001
1000011111
1000000001
100S000001
1000111111
1000000001
1111111111
