

NO textures/sisi.xpm
SO textures/griffith.xpm
WE textures/guts.xpm
EA textures/void.xpm

F 0,255,0
C 225,0,0




11111
10001
10E01
10001
11111
