


















F 255,255,51
C 255 , 0,0

WE                                                 textures/sisi.xpm
SO textures/griffith.xpm
EA textures/void.xpm
NO textures/guts.xpm

11111111111111111111111
1000000000010000000001
10000000000011111111111
1000000000001
1000000000001
1000000000001
100010000000111111111111
1001 1000000000000000001
10001000000000000000N001
100000000000000000000001
111111111111111111111111
