NO textures/guts.xpm






SO textures/griffith.xpm




WE textures/sisi.xpm


EA textures/void.xpm





F                    15,15,15

















C                        125,50,50






11111111111
10000000001
10000000001
10000N00001
10000000001
10000000001
10000000001
11111111111







11111111111111
10000000000001
1000000000001
100000000001
10000000001
1000000001
100000001
10000001
1000001
100001
10001
1001
101
11












