









NO textures/guts.xpm








SO textures/griffith.xpm




    


WE textures/sisi.xpm


    






EA textures/void.xpm



F 15,15,15
C 122,22,22	



1111111111111111111111111
1110000000000000000000001
1111100000000000000000001
1111000000000000111111001
1111111100000001000000001
1111111100011111100100001
1111000000000001100011111
1000000111111111000000001
1111111110000000000000011
1111111100000010101011011
1111111111000000101000111
11110000010N0000000110101
1000000000001111111100011
1111111111111111111111111
